111111111111111
1100C0N0C0000P1
100C0000N0000C1
111NNNN0NNNN111
1CCC1110111CCC1
111000101000111
111110000011111
1CCCCCCCCCCCCC1
111111101111111
111111101111111
11111N000N11111
11111N0E0N11111
111111111111111