111111111111111111111
11N1N1N1N1N1N1N1N1N11
1NC0C0C0C0C0C0C0C0PN1
1101N1N1N1N1N1N1N1N11
1NCNC0C0C0C0C0C0C0CN1
110101N1N1N1N1N1N1011
1NCNCNC0C0C0C0C0CNCN1
11010101N1N1N1N101011
1NCNCNCNC0C0C0CNCNCN1
110101010N0N010101011
1NCNCNCNC0E0CNCNCNCN1
110101010N0N010101011
1NCNCNCNC0C0CNCNCNCN1
11010101N1N1N10101011
1NCNCNC0C0C0C0CNCNCN1
110101N1N1N1N1N101011
1NCNC0C0C0C0C0C0CNCN1
1101N1N1N1N1N1N1N1011
1NC0C0C0C0C0C0C0C0CN1
11N1N1N1N1N1N1N1N1N11
111111111111111111111